1111111111111111111
10000001110110010C1
100P1110000C000C001
10C000000C1100000E1
1111111111111111111
